1 11111111
1 11111111
1        1
1 11111111
1 11111111
1 111X 111
1 1111 111
1 1111 111
1      111
1111 11111
1    11111
1111     1
1111 11111
1111111111